---

This dataset contains information about properties listed for sale on the batdongsan.com website, including area, price, information about the structure and amenities of the property, information related to the documents, posting and expiration dates, as well as related location and category information.

---

Description of the variables in the dataset:
1. area: Area of ​​the property (unit: m²).
2. price: Property price or negotiated price type if no specific price (unit: million or million/m²).
3. facade: Width of the property's facade (unit: m).
4. entrance_wid: Width of the property's entrance (unit: m).
5. floors: Number of floors of the property.
6. direction_home: Direction of the property relative to the house (if any).
7. direction_bal: Direction of the property's balcony (if any).
8. bedroom: Number of bedrooms in the property or information about the number of bedrooms if any.
9. toilet: Number of bathrooms in the property or information about the number of bathrooms if any.
10. status_doc: Status of documents related to the property (eg: Red book, Pink book, Waiting for book, Sales contract).
11. furniture: Information about the furniture in the property (eg: Full, Basic).
12. date_post: Date of posting.
13. date_exp: Expiry date of posting.
14. intent: Purpose of the transaction (eg: Sale).
15. pageType: Type of page on the website (eg: LDP).
16. productId: Product code.
17. projectId: Project code (if any).
18. vipType: VIP type (if any).
19. verified: Verified information (True or False).
20. expired: Expired information (True or False).
21. cateId: Category code.
22. cityCode: City code.
23. districtId: District code.
24. wardId: Ward code.
25. streetId: Street code.
26. pageId: Page code.
